entity	location
People's Republic of China	AS
Haas House	unsure
Iran	AS
Bavaria	EU
Somalia	AF
Halifax Regional Municipality	North America
Catalonia	EU
Norway	EU
Petrozavodsk	EU
Tartu Town Hall	EU
Tuva Republic	AS
Jutulsessen	EU
Liechtenstein	EU
Croom, County Limerick	EU
Binjai	AS
Buenos Aires	SA
Santiago	SA
Alberta Alliance Party	North America
La Condamine	SA
Colonial Brazil	SA
Dutch East Indies	AS
Antananarivo	AF
Cape Town	AF
Bigo Bay	AF
Afghan Transitional Administration	AS
Trento	EU
KMVP-FM	unsure
Ivory Coast	AF
Warsaw	EU
Agartala	AS
Byers Peninsula	AN
Wales	EU
Zulia	SA
Vantaa	EU
Qing dynasty	AS
Isola Dovarese	EU
Pamplona	EU
Achaemenid Empire	AS
Manyakheta	AS
Antarctic ice sheet	AN
United Kingdom	EU
Slovenia	EU
Nebraska Peaks	North America
Bhopal	AS
Newcomer Glacier	AN
Italy	EU
Thessalian	EU
Cambodia	AS
Guinea	AF
Madagascar	AF
Palestine	AS
Registro	SA
Metropolitan France	EU
Tinker Glacier	AN
Kingdom of Mercia	EU
Kyōto Prefecture	AS
Rodez	EU
Wallis Island	OC
Helsinki	EU
Brisbane, Australia	OC
Saint-Louis-de-Kent, New Brunswick	North America
Melnik Peak	AN
Bearpaw Shale	North America
Comoros	AF
Tasmania	OC
Abu Dhabi	AS
Riyadh	AS
Carryer Glacier	AN
Albany	North America
Tōkyō	AS
Long Hills	North America
Bahujan Vikas Aaghadi	AS
Gazakh	EU
Saffery Islands	OC
Riga	EU
Orikhiv	EU
Sarajevo	EU
South Georgia Survey	AN
Daniels Range	AN
Tatsuno	AS
Kamchatka Krai	AS
Eirodziesma	EU
Israel	AS
Kasai-Oriental Province	AF
North Sumatra	AS
Prague	EU
San Juan	SA
Algeria	AF
Grand Duchy of Finland	EU
French Polynesia	OC
Croatia	EU
Tursi	EU
Philadelphia	North America
Vietnam	AS
London	EU
Dufek Massif	AN
Elgin West	North America
Siple Dome	AN
Dili	OC
Miers Bluff	AN
Bandung	AS
Abbasid Caliphate	AS
Jiangsu Province	AS
Cameroon	AF
Guinea-Bissau	AF
Pyongyang	AS
Leeton, New South Wales	OC
Morrison County	North America
Rome	EU
Campania	EU
France	EU
Douglas Range	AN
Bombay	AS
M'banza-Kongo	AF
Jiangxi	AS
Tienen	EU
Pecora Escarpment	AN
Piedmontese	EU
Suriname	SA
Valencian Community	EU
State of Brazil	SA
Dornbirn	EU
Kuala Lumpur	AS
Flask Glacier	AN
Madhya Pradesh	AS
Masaya Department	North America
Buchans	North America
Basel	EU
Mountaineer Range	AN
Mahalangur Himal	AS
Banjarmasin	AS
Andvord Bay	AN
East Flanders	EU
Pourquoi Pas Point	AN
Nyeri County	AF
Kamikita District	AS
Transnistria	EU
Finnish Socialist Workers' Republic	EU
Gazzola	EU
French historian	unsure
Queensland	OC
Portugal	EU
Kidapawan	AS
Rif Dimashq Governorate	AS
Kyrgyzstan	AS
Baku	AS
Harare	AF
Hispaniola	North America
Dakar	AF
Novoarkhangelsk	North America
Pomorie Point	EU
Rio de Janeiro	SA
British Empire	EU
Giles County, Virginia	North America
India	AS
Sadr City	AS
Hays Mountains	AN
Kerala	AS
Switzerland	EU
Russia	AS
Bruges	EU
Tuscany	EU
Hawaii	North America
Cape Legoupil	AN
Belgium	EU
Cuba	North America
Brazil	SA
Brandenburg-Prussia	EU
Prieto Diaz	North America
Ottoman Empire	unsure
China	AS
Lebanon	AS
Oshawa	North America
New France	North America
Yekaterinburg	AS
Uusimaa	EU
San Francisco de Quito	SA
Air New Zealand Flight 901	unsure
Ray Promontory	AN
Hall County, Nebraska	North America
Varna Peninsula	EU
Tajik	AS
Bern	EU
Jerusalem	AS
Straits Settlements	AS
Belgrade	EU
Getz Ice Shelf	AN
Second Spanish Republic	EU
New Castle County, Delaware	North America
CFMJ	North America
Ariake Coliseum	AS
North Kurdufan	AF
Macau	AS
Argentine	SA
Gmina Pokrzywnica	EU
Croatian	EU
Afghanistan	AS
Edo	AS
Guangxi Zhuang Autonomous Region	AS
Shenzhen	AS
Sainshand	AS
Japan	AS
Lazarev Ice Shelf	AN
Tatarstan	EU
Ioannes Paulus II Peninsula	AN
Veyrier	EU
Land Glacier	AN
Paris	EU
Quebec	North America
Uruguay	SA
Uttar Pradesh	AS
Palladam	AS
Handel Ice Piedmont	AN
Jemappes	EU
Vojvodina	EU
Antelope Canyon	North America
Aargau	EU
Norfolk Air	OC
Bad Schwalbach	EU
capital	unsure
Ballydehob	EU
Zucchelli Station	AN
Frasnes-lez-Anvaing	EU
Llandaff Cathedral	EU
Netherlands	EU
Puerto Rico	North America
Beijing	AS
Westminster	EU
Roman Empire	EU
Ross Island	AN
Argentina	SA
Stonehouse Bay	EU
Benson Point	AN
Belarus	EU
Chancelade	EU
Sweden	EU
Tibesti Region	AF
Panzarini Hills	AN
Czech Republic	EU
Lodhran Tehsil	AS
Canary Islands	AF
Bahrain	AS
El Salvador	North America
Tuvalu	OC
Larsemann Hills	AN
Asmara	AF
Punjab, Pakistan	AS
Aucanquilcha	SA
Philadelphia, PA	North America
Silesia	EU
Falun	EU
Aalborg	EU
Ireland	EU
Forster Ice Piedmont	AN
Nicaragua	North America
Hitachinaka	AS
David Glacier	AN
Cork GAA	EU
Mediolanum Forum	EU
Spanish Empire	EU
South Yemen	AS
Planet Heights	unsure
Alikovo	EU
New Jersey	North America
Jan Amora	AF
Hainan	AS
Democratic Republic of Afghanistan	AS
Jiangxi Province	AS
Kotis Point	AN
Clearwater Formation	North America
Saipan	OC
Vinson Plateau	AN
Gaborone	AF
Ecuador	SA
Budapest	EU
Ljubljana	EU
Hattfjelldal	EU
Skole Raion	EU
Pedro Juan Caballero	SA
Antarctic Treaty System	AN
French Second Empire	EU
Simdega	AS
South Kordofan State	AF
Tajikistani	AS
Kazakh	AS
Mozambique	AF
Union between Sweden and Norway	EU
Poland	EU
Nunavut	North America
Darley Hills	AN
Hokkaido	AS
Hilir Perak	AS
Kingdom of the Netherlands	EU
Soviet Union	EU
Islamabad	AS
Finland	EU
San Gregorio Armeno	EU
Rajasthan	AS
Turkmenistan	AS
Col Agnel	AS
Jones Mountains	AN
Erbil SC	AS
Latvia	EU
Santa Cruz de Mompox	SA
Lower Assam	AS
Caribou County, Idaho	North America
Yinchuan	AS
Serbia	EU
Heves County	EU
Oslo	EU
Jammu and Kashmir	AS
Satakunta	EU
Rabat	AF
Egypt	AF
Hungary	EU
Beaglehole Glacier	AN
Orange Free State	AF
Indonesia	AS
Kyoto University	AS
Persepolis	AS
Mexico	North America
Cappoquin	EU
Pakistan	AS
Lovech Heights	EU
Fawkner	OC
People's Republic of Poland	EU
Romania	EU
Alikovsky District	EU
Woodbine Racetrack	North America
Mount Fridtjof Nansen	AN
Allied-occupied Germany	EU
Fujian	AS
Naumburg (Saale)	EU
Avord	EU
North Ossetia	EU
CHN	AS
First Republic	EU
Shirase Glacier	AN
Humboldt County, California	North America
Desolation Lava Field	North America
Botswana	AF
Emona Anchorage	EU
Noyon	EU
Maison du Peuple	EU
Euphrates	AS
Kuthiyathodu grama panchayat	AS
Sarpsborg 08 FF	EU
Aragon	EU
Arab League	AS
Agios Dimitrios	EU
German Empire	EU
Haut Atlas	AF
South Africa	AF
Bulgaria	EU
Monte San Giorgio	EU
Port-au-Prince	North America
Papua New Guinea	OC
Corner Cliffs	AN
Venezuela	SA
Slovakia	EU
Kyiv	EU
Kazakhstan	AS
Kandiaro Taluka	AS
Tughlaq dynasty	AS
Kinshasa	AF
Chapman Snowfield	AN
Tripoli	AF
Colorado	North America
Recovery Glacier	AN
Blaiklock Glacier	AN
Queens Gardens, Brisbane	OC
Copenhagen	EU
Iowa	North America
Kaunas Cathedral Basilica	EU
Philippines	AS
Marie Byrd Land	AN
Ukraine	EU
Bowyer Butte	North America
Valea lui Mihai	EU
Singapore	AS
Sabratha	AF
Southwest Finland	EU
Avitohol Point	EU
Ghatanji	AS
Wellington Island	AN
Kingdom of Sicily	EU
Alte Oper	EU
Atpadi	AS
Honduras	North America
ABC Futebol Clube	SA
Mari El Republic	EU
Cape Mousse	AF
Philadelphia, Pennsylvania	North America
Madrid	EU
Armenia	AS
MacAlpine Hills	AN
Czech	EU
Fish Islands	AN
Barcelona	EU
Free State of Prussia	EU
Padmanabhapuram	AS
Grossglockner	EU
Zagazig	AF
Kigali	AF
Trentino	EU
Delhi	AS
Castleisland Desmonds GAA	EU
Morelos	North America
Bugis Junction	AS
Sovereign Military Order of Malta	EU
Brussels	EU
Tirana	EU
Kingdom of France	EU
Equatorial Guinean	AF
Edward VIII Bay	AN
Finnish	EU
Yadagirigutta Temple	AS
Europe	EU
Valdichiana	EU
WinStar World Casino	North America
Bangkok	AS
Nimmitabel	OC
Uganda	AF
Urangan	OC
Flanders	EU
Pocahontas County	North America
Eupen-Malmedy	EU
Hungarian	EU
Jamaica	North America
Clothier Harbour	North America
Gair Mesa	North America
Hanoi	AS
Kingdom of Libya	AF
Czech Socialist Republic	EU
Morozumi Range	AS
Foothills-Rocky View	North America
Al Madinah Region	AS
Libya	AF
Stabben	EU
New Swabia	AN
Mauritius	AF
Al Daayen	AS
Gobardanga	AS
Syria	AS
Cairo	AF
The Forks, Winnipeg	North America
Boston	North America
Nile	AF
Minamishitara District, Aichi	AS
Papua	OC
Mexican Federal District	North America
Himmelbjerget	EU
Mali	AF
West Sumatra	AS
Lazio	EU
Gammalsvenskby	EU
Chile	SA
La Colle	EU
East Belfast	EU
Seine	EU
Bucharest	EU
Aleppo Governorate	AS
Bilbao	EU
Bolvadin	AS
Plougonven	EU
Kanagawa	AS
Shipley Glacier	AN
Cape Smith	North America
South Korea	AS
Kampala	AF
Bratislava	EU
Fatimid Caliphate	AF
Lusaka	AF
Eswatini	AF
Kingdom of Iraq	AS
Beascochea Bay	AN
Mount Murphy	AN
Pacentro	EU
Havana	North America
Gauteng	AF
Bourbon Restoration	EU
Luxembourg	EU
Indian Antarctic Program	AN
Banyoles	EU
Northern Ireland	EU
Mykolaiv Oblast	EU
George VI Ice Shelf	AN
Azerbaijani	AS
Nigeria	AF
Rantum	EU
Paraguay	SA
Akershus	EU
Russell East Glacier	AN
Northern Bahr el Ghazal	AF
Nye Mountains	AN
Bouygues Telecom	EU
Frosinone	EU
Manikata	EU
Isabela	SA
National Highway 45	AS
McAlester, OK	North America
Uttarakhand	AS
Entente Florale	EU
Medan	AS
Selbu	EU
QLD	OC
Melaka TMFC	AS
Danish	EU
Brown Peninsula	AN
Slab Point	AN
Rothera Research Station	AN
Jiangsu	AS
Bamako	AF
Uda District	AS
Mandatory Palestine	AS
Hanover	EU
Austrian Empire	EU
Levski Ridge	EU
Bhinmal	AS
Club Aurora	AN
Coke County	North America
Isfahan province	AS
Montevideo	SA
Tarnovo	EU
Glencree	EU
Nagaland	AS
Prey Veng Province	AS
Palermo	EU
Ouachita Parish	North America
Flemish Community	EU
Manila	AS
Kathmandu	AS
Baghdad	AS
Pittsburgh, Pennsylvania	North America
Canadian County, Oklahoma	North America
Alpokalja	EU
Heidelberg	EU
British America	North America
Niger	AF
Nizampatnam	AS
Davao del Norte	AS
Chukotka Autonomous Okrug	AS
Central African Republic	AF
Germany	EU
Cook County	North America
Hohenlohe-Langenburg	EU
Ayyubid dynasty	AS
Sapporo	AS
Homs Governorate	AS
Massachusetts Bay Transportation Authority	North America
Jiul de Vest River	EU
Mount Steere	AN
Rājagaha	AS
French	EU
Victor Bay	AN
Higashikagawa	AS
Berlin	EU
Rotch Dome	AN
Canjuers	EU
Belo Horizonte	SA
Brześć	EU
Valvasone	EU
Denmark	EU
Jakarta	AS
occupation of Japan	AS
Amsterdam	EU
New York	North America
Alexander Island	AN
Qiantang	AS
Hamilton County	North America
Hobart	AN
Bastia	EU
Thailand	AS
Somerset	EU
Herāt	AS
La Grange Nunataks	AN
Edmonton	North America
Mount Markham	AN
Ottoman	AS
Ruthweiler	EU
Azerbaijan	AS
Angola	AF
.af	unsure
United Kingdom of Great Britain and Ireland	EU
Garbeta	AS
Panormus	EU
Bosnia	EU
Berkeley County, West Virginia	North America
Neryungri	AS
Bolzano	EU
First Czechoslovak Republic	EU
Austria	EU
Crown Peak	AN
Hokkaidō	AS
United Arab Republic	AS
Berhala Island, Sabah	AS
Ghora Gali	AS
Tripura	AS
Les Bons Villers	EU
Empire of Japan	AS
Didymoteicho	EU
Lagos	AF
Lodi dynasty	AS
Dushanbe	AS
Ozumba	North America
Paktia province	AS
Heilongjiang	AS
Pampilhosa da Serra	EU
Plana Peak	EU
Ransom County	North America
Jennings Promontory	AN
Cook Islands	OC
Mbabane	AF
Sardent	EU
Loppa	EU
Brno	EU
Paramaribo	SA
Capoeira	SA
Stratford-on-Avon	EU
Kingdom of Italy	EU
Bhubaneswar	AS
Quarles Range	AN
Rwanda	AF
Tehri Garhwal district	AS
Third Hellenic Republic	EU
Turgai River	AS
Adare Manor	EU
Kongoussi	AF
Covelli Centre	North America
Wirth Peninsula	AN
City of Cranbourne	OC
Rosebud River	OC
Bhisho	AF
Mirbag-e Shomali Rural District	AS
Washington DC	North America
Guangzhou	AS
Jilin	AS
Augusta Raurica	EU
Oates Land	AN
Vilnius	EU
Vientiane	AS
Raft River Mountains	North America
United States	North America
Malaysia	AS
Cloutierville	North America
Villa La Pietra	EU
Shoranur	AS
Reinbolt Hills	AN
Panega Glacier	EU
Velbert	EU
Kingdom of Bohemia	EU
Sapo National Park	AF
Dominion Range	AN
Melnik Ridge	AN
Tapsell Foreland	AN
Vernayaz	EU
Ustevatn	EU
Kingdom of Hungary	EU
Dumoulin Islands	AN
4th of August Regime	EU
Bayreuth	EU
Taiyuan, China	AS
Toronto Police Service	North America
Tijuana River	North America
Abidjan	AF
Whillans Ice Stream	AN
Fosdick Mountains	AN
Scotland	EU
Poissy	EU
Pinosava	EU
Moon Bay	AN
Arsk	EU
Bolivia	SA
Miramichi Centre	North America
Banten	AS
Cyprus	AS
Lower Juba	AF
cadastral municipality	EU
Willan Nunatak	AN
Perth	OC
Manitoba	North America
Port Moresby	OC
Umayyad Caliphate	AS
Pahlavi	AS
Medical College and Hospital, Kolkata	AS
Sungai Mamberamo	OC
Xi'an	AS
Ghana	AF
Hektoria Glacier	AN
Argentina Range	AN
Flieden	EU
Doyran Heights	EU
Cobham Range	AN
Nesodden IF	EU
Colony of Vancouver Island	North America
Brisbane	OC
Neuburg Peak	AN
Aquila	EU
Guyana	SA
Eredivisie	EU
Goat Rock Beach	North America
New Hampshire	North America
Bihar	AS
Second French Empire	EU
PMR	EU
Hernando County	North America
Hauser & Wirth	EU
Indianapolis	North America
Ostermundigen	EU
Kiev	EU
Kingdom of Afghanistan	AS
Schokalsky Bay	AN
Utah	North America
Hansen Glacier	AN
Fleming Glacier	AN
Mawson Glacier	AN
Dijon	EU
Rashidun Caliphates	AS
Matusevich Glacier	AN
McMinn County	North America
West Dunbartonshire	EU
Mundraga Bay	AN
Maccagno	EU
Crimea	EU
Zelenchukskaya	EU
Breznik Heights	EU
Gorseinon	EU
Surrey	EU
IL Brodd	EU
Brandon University	North America
Ghanaian	AF
Samsun Province	AS
Garkan Rural District	AS
Liberia	AF
Grianan of Aileach	EU
Caracas	SA
Otjozondjupa	AF
Bulgarian	EU
Burundi	AF
Calder Freeway	OC
Sebatik Island	AS
Bangarapet	AS
Eriksbergs Mekaniska Verkstad	EU
Ottawa	North America
New York City	North America
Drummond Glacier	AN
Hampshire	EU
Lewin Brzeski	EU
Colombia	SA
Gobind Sagar	AS
Bohemia	EU
Jaipur	AS
Watson Island	North America
Christian Medical College Ludhiana	AS
Taipei	AS
Bloemfontein	AF
East Java	AS
Scaife Mountains	AN
Shaanxi Province	AS
Shipton Ridge	AN
Greece	EU
Mukkam	AS
East Kalimantan	AS
Toora	OC
County Offaly	EU
Carinthia	EU
Aprilov Point	EU
Allersberg	EU
Arkansas	North America
Sucre	SA
Virginia	North America
Khorasan	AS
Bispebjerg	EU
United States Army Military Government in Korea	AS
Taiwan	AS
Bas-Saint-Laurent	North America
Matabitchuan River	North America
Coulter Heights	AN
Hangzhou	AS
2009 Speedway Ekstraliga	EU
Yerevan	AS
Warsaw Uprising Museum	EU
Acolman Municipality	North America
Lower Saxony	EU
Illinois	North America
Springburn	EU
Manila Bay	AS
Hrtkovci	EU
RA	SA
Ticino	EU
Askola	EU
Suva	OC
Jharkhand	AS
Hesse-Marburg	EU
Madeira	EU
Kassel	EU
Otway Massif	AN
Welschnofen	EU
Gavork-e Nalin Rural District	AS
Vancouver	North America
Bangladesh	AS
Staten Island Heights	North America
Odisha	AS
Muro d'Alcoi	EU
Uromi	AF
Cape Northrop	AN
Dziemiany	EU
Assen	EU
Wiltshire	EU
Portbou	EU
Olten railway station	EU
Ternopil Oblast	EU
Calabria	EU
Cape Verde	AF
Moubray Bay	AN
Umber Island	AN
Saxony	EU
Isfahan International Airport	AS
Fournier Bay	AN
Northeast Glacier	AN
Kansas	North America
Barrientos Island	AN
FC Volochanin-Ratmir Vyshny Volochyok	EU
Fort Madalena	AN
Oder-Spree District	EU
Minas Gerais	SA
Maebashi city	AS
Signy Island	AN
Douglas Peaks	AN
VTB Capital	EU
Roman Catholic Archdiocese of Ljubljana	EU
Howchin Glacier	AN
Winnebago County, Illinois	North America
Sri Lanka	AS
Victoria Upper Glacier	AN
Central Black Forest	EU
Montenegro	EU
Saigon	AS
Gyulafehérvár	EU
Saladin Governorate	AS
Borg Massif	AN
Ontario	North America
Munich Residence	EU
Dawa River	AS
Dagestan	EU
La Bayou	North America
Kenya	AF
Riverside Expressway	AS
Shastri Park	AS
Mark Twain National Forest	North America
Al-Aqsa Mosque	AS
Kondotty	AS
Rouen	EU
Kingdom of Saxony	EU
Carpentras	EU
Gansu	AS
Crosswell Glacier	AN
Squantz Pond State Park	North America
Yakutsk	AS
Perpignan	EU
Punnichy	North America
Lake Timiskaming	North America
Pantin	EU
Posadas, Argentina	SA
Saalekreis	EU
Karnataka	AS
Punta della Dogana	EU
Limbdi	AS
Crucible Theatre	EU
Leinster	EU
Columbia Valley	North America
Zacatecas	North America
Gabon	AF
Calcutta	AS
Festninga Mountain	AN
Tokelau	OC
Chengdu	AS
Flin Flon	North America
Clackmannanshire	EU
Dhule Lok Sabha constituency	AS
Tanzania	AF
Hurley River	AN
Two Step Cliffs	AN
Russian Federation	EU
Miller Range	AN
Moldova	EU
Vienna	EU
Singel	EU
Camandona	EU
Houffalize	EU
Lazarev Mountains	AN
Licodia Eubea	EU
Gmina Stara Kornica	EU
Posadowsky Bay	AN
Delchev Ridge	EU
San Francisco Conservatory of Music	North America
Namibia	AF
bpost	unsure
Iraq	AS
Pragersko	EU
Australian Antarctic Territory	AN
L'Aquila	EU
Gambia	AF
Byzantine Empire	unsure
Heraklion	EU
Molar Massif	AN
Henan	AS
Limoges	EU
Kingdom of Burgundy	EU
Gambacorta Peak	AN
Canberra	OC
Cugnot Ice Piedmont	AN
Sanaa	AS
Bunda District	AF
Umbria	EU
Saratov Oblast	EU
Shipka Saddle	EU
Managua	North America
Bintulu Division	AS
Annweiler am Trifels	EU
Bird's Head Peninsula	OC
Ashgabat	AS
Nevada	North America
West Pakistan	AS
Da Nang Air Base	AS
CD Eldense	EU
Liaoning	AS
Seychelles	AF
Khalji dynasty	AS
Kiribati	OC
Venus Glacier	AN
Tarnovo Ice Piedmont	AN
Wien	EU
Lannemezan	EU
Ulster County	North America
Nicosia	AS
Congo	AF
Pristina	EU
Grand Union Canal	EU
Vrienden van het Platteland	EU
Shablykinsky District	EU
Spain	EU
Trontano	EU
Zuiderzee	EU
Kiev Peninsula	EU
Ba F.C.	AS
Dundee Island	AN
Liberty Island	North America
Graz	EU
Veleka Ridge	EU
Nagoya University	AS
Strom Glacier	AN
Guangdong	AS
Ang Thong	AS
Lisbon	EU
UL Bend National Wildlife Refuge	North America
KKBQ	North America
Geelong Art Gallery	OC
Guatemala	North America
Peru	SA
Macquarie Island	AN
Cerano	EU
Marsh Glacier	AN
Neva	EU
Bose Institute	AS
Changchun	AS
Wyoming	North America
Renfrewshire	EU
Kingdom of Wessex	EU
Oviedo	EU
Kingstown	North America
Oxford	EU
Abu Ghosh	AS
Skopje	EU
Lisiya Ridge	AS
Lucca	EU
Changsha	AS
Helsinki City Hall	EU
Thiruvattar	AS
Queen Charlotte Mountains	North America
Wentworth Valley	OC
Ukrainian State	EU
Reiherstieg Schiffswerfte & Maschinenfabrik	EU
Nasino	EU
USSR	EU
Wismar	EU
Zbuczyn	EU
Taylor Valley	AN
Ambatofinandrahana District	AF
Nanchang	AS
Tovuz District	AS
Tillya Tepe	AS
Baranya County	EU
Sukhumi	AS
Avignon	EU
Santo Stefano d'Aveto	EU
Idaho	North America
Laos	AS
Corse-du-Sud	EU
Yunnan	AS
Mumbai	AS
Sichuan	AS
1C Company	unsure
Hotel Oloffson	North America
Mutsamudu	AF
Wadhwan	AS
Bedourie	OC
Obwalden	EU
Landskrona BoIS	EU
Wallmerod	EU
Cape Evensen	EU
Jablanica District	EU
Moscow	EU
Halls Stream	North America
SEC Armadillo	EU
Real County	North America
Senegal	AF
Viseu	EU
Kyrgyz SSR	AS
Mogadishu	AF
Nizamabad district	AS
Andhra Pradesh	AS
Canada	North America
Bad Wildungen	EU
Fluminense F.C.	SA
Lions Rump	AF
South Beaches	OC
Zimbabwe	AF
Uzbekistan	AS
Tamil Nadu	AS
Galiano Island	North America
Patna	AS
Anatolia Eyalet	EU
Morval	EU
San Giorgio Canavese	EU
Mississippi	North America
Pinecreek	North America
Mertz Glacier	AN
Winnipeg	North America
Kalani High School	OC
US	North America
Lerik District	AS
Amos Anderson Art Museum	EU
Transantarctic Mountains	AN
Scylla Glacier	AN
Rampart Ridge	AN
Hartley County	North America
Mauritania	AF
Canadian	North America
Wiesbaden	EU
America	unsure
Florence	EU
Tallinn	EU
Astana	AS
Rubicon	EU
Rowhedge	EU
Dunedin Range	OC
Tang	AF
Hood Glacier	AN
Shropshire	EU
Cleveland Glacier	AN
Martin Hills	AN
Soalala	AF
Lake Vanda	AN
Aylesbury	EU
Amreli district	AS
Mercator Ice Piedmont	AN
Cadgwith	EU
Buckeystown	North America
Suffolk County	North America
Freetown	AF
Kahnawake, Quebec	North America
Nizhneserginsky District	EU
Langtang National Park	AS
Imperial Trans-Antarctic Expedition	AN
San Antonio River	North America
Kalvola	EU
Shimla	AS
Pekanbaru	AS
Tajikistan	AS
Pittsburgh	North America
Accra	AF
New South Wales	OC
Vinson Massif	AN
Maharashtra	AS
Pernambuco	SA
Waltham High School	North America
Bertram Glacier	AN
Bukit Panjang Single Member Constituency	AS
Canossa	EU
Honey War	North America
Mainz	EU
Mount Hornsby	OC
British Guiana	SA
Waldshut-Tiengen	EU
Nez Perce County	North America
Paisley	EU
Berkovitsa Glacier	EU
Knockmealdown Mountains	EU
Celilo Village	North America
Demas Range	AN
Pazhayangadi	AS
Veracruz	North America
Nouakchott	AF
Hunan	AS
Spanish East Indies	AS
Kota Kinabalu	AS
Aventine Hill	EU
Babcock & Brown	unsure
Sidhi district	AS
Berens River	North America
Mumiy Troll	EU
Colombo	AS
River Waveney	EU
Demerara	SA
Clare	EU
Eureka Glacier	AN
Sofia	EU
Allegheny County	North America
Weimar Republic	EU
Makkah Region	AS
Abruzzo	EU
Theni district	AS
Massachusetts	North America
Castlehaven	EU
Donskoy Monastery	EU
Penclawdd	EU
Baja California	North America
Osaka	AS
South Sudan	AF
IJmuiden	EU
Ixelles	EU
Vaduz	EU
Devon	EU
Sestola	EU
Hebei	AS
Antim Peak	AN
Delta Works	EU
Venezia	EU
Camarate	EU
Cenepa River	SA
Rewas	AS
Shandong	AS
Botad	AS
Macedonia	EU
Equatorial Guinea	AF
Saint Gayane Church	AS
Ateneo de Madrid	EU
FC Gorodeya	EU
Hohenwestedt	EU
Greek People	EU
Beneden Merwede	EU
La Ribera Baixa	EU
Bowman Peninsula	AN
Dominion of Pakistan	AS
Mewat	AS
Foyn Coast	AN
Marstrand	EU
West Bengal	AS
agglomeration community	unsure
Wabush Airport	North America
Constantinople	EU
Amsterdam dance event	EU
Bighorn River	North America
Penna Ahobilam	AS
Melbourne	OC
Wilhelmina Bay	AN
Gavrilovo-Posadsky District	EU
Korea	AS
90.3 ABC Sunshine Coast	OC
Hyderabad	AS
Loy Yang Power Station	OC
Electoral district of Wantirna	OC
Avery Plateau	OC
Castrovirreyna District	SA
Bad Camberg	EU
Grimaldi Industri	EU
Dublin	EU
Indus River	AS
Guelma Province	AF
Concordia Station	AN
Rankuh District	AS
Nord-Pas-de-Calais	EU
Hannover	EU
Persegres Gresik United	AS
Gmina Sorkwity	EU
Conakry	AF
Atna Peaks	AN
Vale of Glamorgan	EU
Araria district	AS
Monrovia	AF
Eldkvarn	EU
Former Shu	AS
Batagay	AS
Kadrina Rural Municipality	EU
Publications Ice Shelf	AN
Bilohirsk Raion	EU
Bishkek	AS
Bandra	AS
Windigo Lake	North America
Camp Tarawa	OC
Storm Peak	North America
Alberta	North America
Sydney	OC
Carcassonne	EU
Cuzco	SA
Shetland Isles	EU
Collina d'Oro	EU
Owen Ridge	OC
Sommariva del Bosco	EU
Sierra Leone	AF
Vorarlberg	EU
Leap Castle	EU
Achelous River	EU
Petvar Heights	AS
England	EU
Australia	OC
Swifts Creek	OC
Turkey	AS
Pechora River	EU
Assiginack	North America
Recife	SA
Pennsylvania	North America
Turku	EU
Art Gallery of Ontario	North America
Indira Gandhi National Open University	AS
Gmina Kalinowo	EU
Condor Peninsula	SA
Anak Bukit	AS
Buraswa	AF
Ginza	AS
Paulet Island	AN
La Mauricie National Park	North America
Nantes	EU
Debenham Glacier	AN
Radnevo Peak	EU
Little Bear River	North America
Toluca	North America
Alebtong District	AF
Veneto	EU
Vistula	EU
Sussex	EU
Barwick Valley	AN
Hantsavichy	EU
Piasa	North America
Suwayq	AS
Riiser-Larsen Ice Shelf	AN
Florida	North America
Drexel University College of Medicine	North America
Santo Domingo	North America
Stockholm	EU
Congo basin	AF
Toronto	North America
Marshall Mountains	OC
University of Bern	EU
Kennedy Space Center	North America
NYC	North America
North Holland	EU
Eurostat	EU
Churchill Peninsula	North America
Brown University	North America
Strait of Kerch	EU
Big Timothy Mountain	North America
Des Moines International Airport	North America
Banesh Rural District	AS
Srebarna Glacier	EU
Eritrea	AF
Executive Committee Range	AN
Juan de Nova Island	AF
Beall Island	North America
Luapula River	AF
Smith Glacier	AN
Yamato Museum	AS
Autonomous District Lok Sabha constituency	AS
Fall Creek Falls State Park	North America
Yokohama International School	AS
Pesisir Selatan	AS
Conneaut Creek	North America
Sudan	AF
Trinity Peninsula	AN
Lassen County	North America
Indian Institute of Science	AS
NY	North America
prefectural road	AS
Mount Weaver	OC
National Law School of India University	AS
College of Engineering, Pune	AS
Mauricie	North America
Reverchon Park	North America
Malta	EU
All-Ukrainian Union "Svoboda"	EU
Carolingian Empire	EU
Manatawny Creek	North America
Panna National Park	AS
Steenwijk	EU
Arno	EU
Trans-Sahara Highway	AF
McFarlane Strait	AN
Coolock	EU
Pontecorvo	EU
Papantla	North America
Swedish Empire	EU
Instituto Pedro Nunes	EU
Nepal	AS
Quito	SA
Opel	EU
Halland	EU
European Physical Society	EU
Smart Museum of Art	North America
Pequod Glacier	AN
Cape Barne	AN
Kelly Field Annex	North America
Dhaka	AS
Vinkeveen	EU
Ottawa, Ontario	North America
Kyustendil Province	EU
Oregon	North America
Balige	AS
South America	SA
Prattville High School	North America
Heavenly Mountain Resort	North America
Charles Lang Freer House	North America
Heptapyrgion	EU
Gmina Leszno	EU
Juan Carlos I Antarctic Base	AN
Benedict College	North America
Allan Cup	North America
Brialmont Cove	EU
Lesotho	AF
Sardinia	EU
Scottish	EU
Russian SFSR	EU
North Berwick	EU
Lambert Glacier	AN
Lund Municipality	EU
Sitkalidak Island	North America
Nyamuragira	AF
Yugoslavia	EU
Khmilnyk	EU
Estonia	EU
Prydz Bay	AN
Gracie Mansion	North America
Green Glacier	AN
Wythenshawe Hall	EU
Frostlendet Valley	AN
Myongji University	AS
Roman Catholic Archdiocese of Lucca	EU
FC Anker Wismar	EU
Albemarle County, Virginia	North America
Cookley	EU
Cape Williams	AN
Dresden	EU
Cape Colbeck	AN
Whiteshell Laboratories	North America
Guggenheim Museum	North America
Weston GO Station	North America
Chechnya	EU
Tarn Taran district	AS
Hong San See	AS
Etobicoke North	North America
Turaida	EU
Kalookan	AS
Roman Four Promontory	AN
Mount Manthe	AF
Iximche	North America
Fermilab	North America
Palmer Land	AN
Veysian Rural District	AS
Missouri	North America
Iskar Glacier	EU
New Smyrna Speedway	North America
Turkmen	AS
Dewa Province	AS
McMurdo Station	AN
Minnesota Glacier	AN
Watson Escarpment	AN
home counties	EU
936 ABC Hobart	OC
Second Rutte cabinet	EU
Lauterecken-Wolfstein	EU
Aconcagua	SA
Penney Bay	North America
Von Essen Mountain	AN
Ma River	AS
Mahur Berenji Rural District	AS
Exarchate of Ravenna	EU
Balochistan	AS
Erfurt	EU
Lithuania	EU
Calw	EU
Skeidshovden Mountain	EU
Pigtown	North America
Ulpiana	EU
Hobart Zoo	OC
Merrick Mountains	AN
Discovery Expedition	AN
Ponoy River	AS
Payer Mountains	AN
Hauts-de-Seine	EU
Harnaut	AS
Pearse Valley	AN
English Channel	EU
Sarnaki	EU
Tom McCall Waterfront Park	North America
Kume District	AS
Côte d'Ivoire	AF
Trelech	EU
York Mills Bus Terminal	North America
Garibaldi Ranges	North America
North Hwanghae province	AS
House of Representatives	unsure
Tovarnik	EU
Hoseason Island	AN
Maury County	North America
Guadalquivir	EU
Sindh	AS
Evans Peak	North America
Torgau	EU
2010 Winter Olympics	unsure
Tbilisi	AS
Tampere Cathedral	EU
ITE College East	AS
Helmbrechts	EU
Waurn Ponds	OC
Mount Discovery	AN
Dandenong	OC
Harsewinkel	EU
La Guajira Department	SA
Viking Age	EU
Bhamdoun	AS
Blue Earth County, Minnesota	North America
Haaga	EU
Knox Coast	AN
Chol Kiri District	AS
Pendleton Strait	OC
Eland Mountains	AF
Nova Scotia	North America
Craiova	EU
Madona District	EU
Schwules Museum	EU
Bernheze	EU
Kolkata	AS
Lakhpat	AS
Cape Evans	AN
Minneapolis	North America
Uinta Basin	North America
British Columbia	North America
Rouen Mountains	AN
Pautalia Glacier	EU
Elbe	EU
Italian	EU
Gazzo Veronese	EU
Warszawa Wschodnia Osobowa railway station	EU
Carnegie Deli	North America
Rambo Nunataks	AN
Welford Road Stadium	EU
Ojos del Salado	SA
Kashmir	AS
Telangana	AS
German National Library	EU
Anschutz Medical Campus	North America
Alpha Island	OC
Davis Sea	AN
Gulf of Bothnia	EU
Knoxville metropolitan area	North America
Peremyshliany	EU
Bertha Island	OC
Despotate of Epirus	EU
Murcia	EU
Nairobi	AF
Palais de l'Industrie	EU
Schleitheim	EU
Saharsa district	AS
SFR Yugoslavia	EU
Temples of Abu Simbel	AF
Everleigh Club	North America
Zoo Miami	North America
Hunter College	North America
Mississauga Centre	North America
Udupi district	AS
Kentucky	North America
Bellinzona	EU
Morecambe	EU
Stepanakert	AS
Antarctic Plateau	AN
Astrolabe Glacier	AN
Borgo San Martino	EU
Cape Shirreff	AN
Sjogren Glacier	AN
Burkina Faso	AF
Buryatia	AS
Ichchapuram	AS
Bull Pass	OC
Electoral district of South Bourke	OC
Hi Corbett Field	North America
Hida Mountains	AS
Eiger	EU
Temple Lot	North America
Powys	EU
Gurudwara Bangla Sahib	AS
Idalium	EU
Upper East Region	AF
Broken Pencil	unsure
Williams Point	AN
Bransfield Strait	AN
VR warehouses	unsure
Malawi	AF
Birchall Peaks	AN
Guldborg	EU
Pulaski County Special School District	North America
Tarq Rud Rural District	AS
Bowman Glacier	AN
Rock al Parque	SA
Windischeschenbach	EU
Sulaimaniyah International Airport	AS
Terrebonne Parish	North America
Tigris	AS
Barcellona Pozzo di Gotto	EU
Berkshire	EU
Saskatchewan	North America
Shackleton Range	AN
Dundalk	EU
Kuwait	AS
Brooklyn Island	AN
Toulouges	EU
Lions' Gate	AS
Bani River	AF
California	North America
South Korean	AS
Plateau Station	AN
Pensacola Mountains	AN
Al Shindagha	AS
Ohio	North America
Colbert Mountains	AN
Madhepura district	AS
Paynes Prairie	North America
Mitchell Peninsula	AN
Tennessee	North America
New Mexico	North America
Mount Wade	AN
Kottarakkara	AS
Umatilla County, Oregon	North America
Downtown Orlando	North America
Ravens Mountains	AN
Nimrod Glacier	AN
La famille Plouffe	unsure
Queen Maud Land	AN
Big Thicket National Preserve	North America
Kukri Hills	AS
Mars Glacier	AN
Lanyon Place railway station	EU
Lake Marble Falls	North America
Atwell Peak	AN
Luray Caverns	North America
Eisenach	EU
Kristiania	EU
Balchen Mountain	AN
Zarqa Governorate	AS
Edina High School	North America
Rose Tower	AS
Vermont	North America
Great Whale River	North America
Scotia Bay	AN
Cornerhouse	EU
Mount Mentzel	AN
Marugame	AS
One Raffles Place	AS
Area codes 402 and 531	North America
Pitt Islands	OC
Clark Mountains	AN
Mariner Glacier	AN
Millbrae station	North America
Sydney Peace Prize	OC
Neptune Glacier	AN
Federally Administered Tribal Areas	AS
Hamilton Mountain	North America
Haikou	AS
Convoy Range	AN
Point Douglas	North America
Thiel Mountains	AN
Nuri	AF
Prespa Glacier	EU
Cosgrove Ice Shelf	AN
Mount Carmel	AS
Cocconato	EU
Saudi Arabia	AS
Fischenthal	EU
Veere	EU
JVC Kenwood Victor Entertainment	AS
Prussian Partition	EU
McClain County	North America
Bais Hatalmud	AS
Tsuno District, Yamaguchi	AS
Jane Franklin Hall	OC
Amarkantak	AS
Martinique	North America
Renier Point	AN
Guest Peninsula	AN
Party of National Unity	unsure
Drake Well	North America
Emmanuel Glacier	AN
Ma'rib Governorate	AS
Ryder Bay	AN
Sydney, Australia	OC
Were Ilu	AF
Collins Harbour	AN
Danger Islands	AN
Erlangen	EU
Circuit des Ardennes	EU
Buffalo County	North America
Strasbourg	EU
Duchy of Brabant	EU
Uttaradit	AS
Karimnagar district	AS
Robertson Bay	AN
Seal Nunataks	AN
Norfolk State University	North America
Botnneset Peninsula	EU
AA Drink-leontien.nl	unsure
Riau	AS
Chad	AF
Mulock Glacier	AN
Uranus Glacier	AN
Maya River	North America
Bellingshausen Sea	AN
Voden Heights	AF
Primorye	AS
Morocco	AF
Khentii Province	AS
Principality of Sealand	EU
Tanga Region	AF
Tiruvannamalai district	AS
Circle Centre	North America
Manila Light Rail Transit System	AS
Puerto Maldonado	SA
Robinson Group	AN
Mirabito Range	AN
Albanus Glacier	AN
Morona Santiago	SA
Evans Peninsula	AN
Vermilion Pass	North America
Mule Peninsula	AN
Cape Waite	AN
Johns Hopkins University	North America
George V Coast	AN
Wharton County	North America
Texas	North America
Martin Goodman Trail	North America
Cayeux-sur-Mer	EU
Anahuac National Wildlife Refuge	North America
Assam	AS
County of London	EU
Eastern Bloc	EU
San Marino	EU
Ottoman State	EU
Kahrizak	AS
Blennerville	EU
Aitcho Islands	AN
Tisza	EU
Nou Barris	EU
Karonga	AF
Ethiopia	AF
Crevasse Valley Glacier	AN
Odbert Island	AN
Hamilton Heights	North America
Mount Hallgren	AN
Bosnia and Herzegovina	EU
New Bedford Whaling Museum	North America
Brahms Inlet	AN
Sykes Glacier	AN
Clare Range	AN
Torresdale	North America
Fort Humboldt State Historic Park	North America
Timor-Leste	OC
Benin	AF
Milano	EU
Galerie des Machines	EU
Swaziland	AF
Bzura	EU
Cape Burks	AN
Miers Valley	AN
Eisenhower Range	AN
Mount Boreas	AN
Holtedahl Bay	AN
Arctowski Peninsula	AN
Noliko Maaseik	EU
Edmonton City Centre (Blatchford Field) Airport	North America
Alte Nationalgalerie	EU
St. Louis	North America
Paudash Lake	North America
Chandigarh	AS
Desko Mountains	AN
Imsland	EU
Shire of Mount Alexander	OC
Grand Canyon National Park Airport	North America
Medaram	AS
Sevilla	EU
Bourg-la-Reine	EU
Montemitro	EU
mumok	EU
Kings Domain	OC
Geelong Ring Road	OC
Hammer Point	AN
Albany, Texas	North America
Menangle Park	OC
Bullion Mountains	North America
Arizona	North America
Gateway Motorsports Park	North America
Darwin Mountains	AN
Teres Ridge	AN
Avery County	North America
Hull Bay	North America
Coppermine Peninsula	AN
Hadzhidimovo	EU
Hagenow	EU
Sanaag	AF
Millwood Lake	North America
Zwiefalten	EU
Yule Bay	AN
Reedy Glacier	AN
Nintendo	unsure
Gordon Glacier	AN
Keith County	North America
University of Vermont	North America
Yoro	North America
Washington Escarpment	AN
Museo Correr	EU
Fayette	North America
Castle	North America
Brown Hills	OC
Andheri	AS
Coulman Island	AN
Western Area	AF
San Lorenzo Valley	North America
Anare Mountains	AN
Denton Glacier	AN
Roma Termini railway station	EU
Newell Point	AN
Mount Tyree	AN
Gibraltar	EU
Pioneers Escarpment	AN
Shakhenat Rural District	AS
Languedoc-Roussillon	EU
El Oued Province	AF
Struma Glacier	AN
Little Belt Mountains	North America
Hong Kong	AS
Beaumont Bay	AN
Naval Air Station South Weymouth	North America
Byrd Station	AN
George V Land	AN
Sydney Sports Ground	OC
Montebruno	EU
Kumasi	AF
Tarn-et-Garonne	EU
Marin Counties	North America
Boston University Marsh Chapel	North America
Libby Dam	North America
Seoul	AS
Biscoe Islands	AN
San Diego High School	North America
Mount Stephenson	AN
Slaithwaite	EU
Battle of Montereau	EU
Dion Islands	AN
Universidad Nacional Federico Villarreal	SA
Rothschild Island	AN
Daman and Diu	AS
Dundee Whaling Expedition	AN
Fenn Tower	North America
Bissau	AF
Holdsworth Glacier	AN
Cartographers Range	AN
Pickwick Island	AN
Lone Pine Koala Sanctuary	OC
Pully	EU
DR Congo	AF
Lufkin	North America
Verona	EU
Konark Sun temple	AS
Masson Range	AN
Lleida	EU
Illertissen	EU
Aden	AS
Honnavar	AS
Mount Passel	AN
Kosi Zone	AS
Malita	AS
Laurie Island	AN
Festning Tunnel	EU
Holyrood Secondary School	EU
Owens Valley Radio Observatory	North America
Mount Electra	AN
Rose Valley Glacier	AN
Houston	North America
White Stag sign	North America
Cape Hallett	AN
Shkhara	EU
Holycross-Ballycahill GAA	EU
Kowsar County	AS
Payyavoor	AS
Ogrodzieniec	EU
Wapekeka First Nation	North America
Gainesville Municipal Airport	North America
Peshawar	AS
M&T Bank Stadium	North America
New Democratic Party Socialist Caucus	North America
Saint-Jacques-de-la-Lande	EU
Crab Orchard National Wildlife Refuge	North America
Hannah Point	AN
Palupera Rural Municipality	EU
Dumka district	AS
Alexandra Palace railway station	EU
Novokuybyshevsk	EU
Lambayeque	SA
Shikellamy High School	North America
Fraunces Tavern	North America
Tokyo	AS
Bathurst	OC
Berea College	North America
Tesco Organisation	EU
Isla Grande de Tierra del Fuego	SA
Labuan	AS
Issenheim	EU
Surveyors Range	AN
Minsk	EU
Sugarloaf Key	North America
Fort Collins Municipal Railway	North America
Gmina Kleczew	EU
Spuyten Duyvil Bridge	North America
Tile Ridge	AN
Surat Basin	OC
Conrad Mountains	AN
Noll Glacier	AN
Mount Melbourne	AN
Ellsworth Land	AN
Nishi-Matsuura District	AS
Seefeld	EU
Drygalski Mountains	AN
Tinapa Resort	AF
Leyden	North America
A25 road	EU
Panagarh	AS
Steventon Island	AN
Western Australia	OC
South East Forests National Park	OC
Founders Peaks	AN
Gerlache Strait	AN
Hamden Hall Country Day School	North America
Mahikeng	AF
Mount Longhurst	AN
Solvay Mountains	AN
Jupiter Glacier	AN
Arkell Cirque	AN
Winlaton Youth Training Centre	EU
Vesuvius Observatory	EU
Autonomous University of Madrid	EU
Hennepin County	North America
Ipswich	OC
Palazzo Borghese	EU
Place Bonaventure	North America
Otterbein University	North America
Walter Reed National Military Medical Center	North America
Spicket River	North America
Ticho House	AS
Tundzha Glacier	EU
Simcoe	North America
French Guiana	SA
Kosciuszko Bridge	North America
Miziya Peak	AS
Saint Petersburg	EU
Norwegian Museum of Cultural History	EU
Waalhaven	EU
Montreal Centre	North America
Mosque of Uqba	AF
Iqaluit	North America
Southern Cross Mountains	AN
Pershing County	North America
Ruppert Coast	AN
Samuel Merritt University	North America
Iraklis F.C.	EU
Bermel Escarpment	AN
Mount Harker	AN
Naples	EU
Maury Bay	AN
Kretinga	EU
plaza de Cibeles	EU
Scheibbs District	EU
Henbury	OC
David Island	AN
Kishacoquillas Valley	North America
British Graham Land Expedition	AN
The Hague	EU
Casiquiare canal	SA
Open University of Catalonia	EU
Maglenik Heights	AN
Minnesota	North America
Sturt Highway	OC
Cohasset High School	North America
National Republican Greek League	EU
Andersson Island	AN
Tussey Mountain	North America
Hohenlohe	EU
People's Party for Freedom and Democracy	EU
Willan Saddle	OC
Quintana Roo	North America
Vrancea County	EU
Jhelum River	AS
East River Greenway	North America
Moe Island	AN
Lunenfeld-Tanenbaum Research Institute	North America
Carpathian Mountains	EU
Mandailing language	AS
Cape Longing	AN
Public Broadcasting Services	AF
Spur Point	AN
Pare Glacier	AN
Contell Glacier	AN
Griffith Glacier	AN
Zagreb	EU
Canton of Schaffhausen	EU
Zaire	AF
Scioto County	North America
Achaean Range	EU
Volga Bulgaria	AS
Arthur	North America
Mount Farrell	AN
North Middlesex, Ontario	North America
Venta	EU
University of Zaragoza	EU
Lake Vida	AN
Quartz Hills	OC
Nova Friburgo	SA
Lanusei	EU
Ayn Halaqim Subdistrict	AS
Cannonball Cliffs	AN
Poncha Pass	North America
Presbyterian High School	AF
Sydney Hospital	OC
Argosy Glacier	AN
Nagoya	AS
Prachin Buri River	AS
Yellowstone National Park	North America
Buchan	OC
Djibouti	AF
Taipei City	AS
Qatar	AS
Kittitas County	North America
Phnom Penh	AS
Northern Foothills	SA
South Lanarkshire	EU
Kent	EU
Derbyshire	EU
Vaujany	EU
Detaille Island	AN
Rhayader	EU
WEZF	North America
Rio Quente	SA
Leech Lake Indian Reservation	North America
Pomfret School	North America
Salamander Range	AN
Expo 86	North America
Kuching	AS
Sacramento Convention Center Complex	North America
Tukvar Tea Estate	AS
Battambang Province	AS
Olot	EU
Hugi Glacier	AN
Torreys Peak	North America
Austria-Hungary	EU
Lismore GAA	EU
Huntress Glacier	AN
Astara District	AS
Gasunie	EU
Southern Netherlands	EU
Cape Perez	AN
M5 motorway	EU
Riverway, Townsville	OC
Operation Teapot	North America
Kfar Giladi	AS
Wiseton	North America
Arrival Heights	AN
Atlantic Club Ridge	AN
Caerdydd	EU
Kohler Range	AN
Jennings	OC
Willamette Valley AVA	North America
Lamplugh Island	AN
Clonlara GAA	EU
Gibbs Glacier	AN
North Las Vegas Airport	North America
Albian Sands	North America
regiopolis	North America
Vila Real District	EU
Irtysh river	AS
Gunter Annex	North America
Vardasht Rural District	AS
Aichi Prefecture	AS
San Canzian d'Isonzo	EU
Rajkot	AS
Mount Kempe	AN
Swanson Mountains	AN
Devikulam	AS
Mount Saint Elias	North America
Arve	EU
Tlaxcala	North America
south Sumatra	AS
Boyana Glacier	AN
A229 road	EU
Clarke County, Alabama	North America
Treuchtlingen	EU
Romulus Glacier	AN
Minu District	AS
Cape Rymill	AN
Cape Adriasola	AN
Borovsky District	EU
Gadag district	AS
Carlota Cove	AN
Monarcas Morelia	North America
Taebong	AS
Tampines Expressway	AS
Howard Glacier	AN
Gilroy High School	North America
Karun	AS
Loire	EU
Louth County Council	EU
Schreckhorn	EU
Kafriya	AS
Mackellar Inlet	AN
Tobin Lake	North America
Kondofrey Heights	AS
Balkan Snowfield	AN
Sanlih E-Television	AS
Sutherland	OC
Dublin City	EU
Florentine	EU
Breege	EU
Baturyn	EU
Carnegie Vanguard High School	North America
Growler Valley	AN
Athens	EU
Bonn	EU
Shiver Point	AN
Fort William Point	AN
Keltie Glacier	AN
Damascus	AS
Sind	AS
Piove di Sacco	EU
Atbarah River	AF
Hooge Crater Commonwealth War Graves Commission Cemetery	EU
Lawrence Heights	North America
KU Leuven	EU
Davis Coast	AN
Yemen	AS
Interstate 69	North America
Grayson Stadium	North America
Stratford Army Engine Plant	North America
Genoa	EU
Chavez Island	AN
Moissac Abbey	EU
Morgan Inlet	AN
Lake Bluff	North America
Rockefeller Mountains	AN
Kanata South Ward	North America
Plymouth Rock	North America
Foundation for a Free Information Infrastructure	EU
Cape Bird	AN
Westridge School	North America
Black Coast	AN
Louisiana	North America
Tegucigalpa	North America
Abbey of Echternach	EU
Gaiola	EU
Tixtla	North America
KiKa	EU
Czechoslovakia	EU
Paulding Bay	North America
Sobral Peninsula	AN
Maybach	EU
Butler Glacier	AN
Santa Maria da Feira Municipality	EU
Fryderyk Chopin University of Music	EU
Union University	North America
State Library of Victoria	OC
Rezen Knoll	AN
Sultan Ahmed Mosque	AS
Second Polish Republic	EU
32nd Indiana Monument	North America
Bosnian	EU
Antarctic Plate	AN
Risod	AS
Hippocrates Glacier	AN
Mount Foster	AN
Medgar Evers College	North America
Augustinergasse	EU
Nebraska State Capitol	North America
Victoria, Australia	OC
Rutgers Glacier	AN
Koriya district	AS
AMK Hub	AS
Soviet	EU
Niamey	AF
Tiber	AS
Leelanau Peninsula	North America
Kupreanof Island	North America
Shanxi	AS
Coal Exchange	EU
Mayotte	AF
Milbertshofen-Am Hart	EU
Erickson Bluffs	North America
Foundation Ice Stream	AN
TROS	EU
Chechen-Ingush ASSR	AS
Long Plain First Nation	North America
route 75	North America
Logatec	EU
Kirkpatrick Glacier	AN
Williams Hills	OC
Vernadsky Research Base	AN
West Ardsley	EU
Chaville	EU
Samuel Peak	AN
Tlaquepaque	North America
Papanasam	AS
Munich	EU
Havre Mountains	AN
Barksdale Air Force Base	North America
Ufa	EU
McMichael Canadian Art Collection	North America
Gaoua	AF
Dakor	AS
Morioka	AS
Edinburgh Hill	AN
Weber Inlet	AN
Simcoe Composite School	North America
Waynesville School District	North America
Sheaf Square	EU
Terra Nova Bay	AN
Malha	AS
Jones Bluffs	AN
Gulf Coast of the United States	North America
North-Rhine Westphalia	EU
Kununurra	OC
MacKenzie Bay	AN
Cape Penck	AN
Harris County, Texas	North America
Reval	EU
Welcome Mountain	OC
Tapley Mountains	AN
Norwegians	EU
Buda	EU
Christie Pits	North America
Beacon Supergroup	AN
Norfolk	North America
Mount Paris	OC
Borchgrevink Glacier	AN
Sena Medal	AF
Rutherford County	North America
Chad Basin	AF
Polish Football Association	EU
Mount Cameroon	AF
Marsden State High School	OC
Wavertree	EU
Kibungo Province	AF
Peacock Sound	AN
Garvin County	North America
Lwengo District	AF
The Gullet	AN
Hinkley Glacier	AN
Holmbury St Mary	EU
Liverpool Range	OC
Servus Credit Union Place	North America
Québec	North America
Absheron District	AS
Manassas Regional Airport	North America
Wallonia	EU
Halton County, Ontario	North America
Gangseo District	AS
Lucy Glacier	AN
Opalchenie Peak	AN
Ca' Pesaro	EU
Somontano	EU
Neny Island	AN
Chester Cone	AN
Zlatibor District	EU
Gmina Olsztyn	EU
Ottawa River	North America
Schwyz	EU
Hyderabad Deccan railway station	AS
Herbert Range	AN
Melchior Islands	AN
Rocky Mountain National Park	North America
Morshi	AS
Brest Region	EU
Mount Schuyler	OC
Borghetto di Vara	EU
Lipscani	EU
Thiruvananthapuram	AS
Bon Pastor	EU
Toulouse	EU
West Indies	North America
Pakpattan	AS
Alathur	AS
Ginza Line	AS
Grindley Plateau	AN
Falerone	EU
Flying Fish Cove	OC
The New School for Jazz and Contemporary Music	North America
Zambia	AF
Villars-Burquin	EU
Kuomintang	AS
Kunming	AS
Redland Bay	OC
Crystal Sound	AN
Botzen	EU
Addanki mandal	AS
Glascock County	North America
Gornergrat	EU
Teshie	AF
Halpern Point	AN
Liard Island	North America
Eros Glacier	AN
Lamongan	AS
Probuda Ridge	AN
Mount Black	AN
Davan	AS
Al Muthanna Governorate	AS
Party for Freedom	EU
Cape Adams	AN
Bannu	AS
Beauvais	EU
Palana	AS
Heritage Range	AN
Teatro Comunale Florence	EU
West Royalty, Prince Edward Island	North America
Walker Mountains	AN
Lascaris Battery	EU
Littoral	AF
Drumheller-Stettler	North America
Yamato 000593	AN
Tanglewood	North America
Sartorius Point	AN
Kochi	AS
Norway Bight	EU
Dennistoun Glacier	AN
New Delhi	AS
Jonava District Municipality	EU
Sahneh County	AS
Medina Peaks	AN
Warren Range	AN
Kaloyan Nunatak	AN
Longyearbyen	EU
Democrats 66	EU
Tolima	SA
Indira Gandhi International Airport	AS
Denfeld Mountains	AN
Austin College	North America
Global Television Network	North America
Beles River	AF
Hertfordshire	EU
Katwijk aan den Rijn	EU
Bogra Zilla School	AS
WA	OC
McKinnon Island	North America
Greater Rio de Janeiro	SA
French West Africa	AF
Bedworth	EU
Mount Lister	AN
Rennick Glacier	AN
North Stonington	North America
Cirta	AF
Marikina	AS
Iruma Air Base	AS
Chevron Science Center	North America
Frigate Range	AN
Konya	AS
Goma	AF
Kurinjimala Sanctuary	AS
Staatliche Antikensammlungen	EU
Rancho Los Encinos	North America
Risemedet Mountain	EU
SV Ried	EU
German Confederation	EU
Kingsley Field Air National Guard Base	North America
Itawamba	North America
Wisconsin	North America
Jorum Glacier	AN
Alfred Wegener Institute for Polar and Marine Research	AN
Mount Tyrrell	AN
Rancho Castac	North America
Crook, County Durham	EU
Capdenac	EU
Saturn Glacier	AN
Enghien-les-Bains	EU
Randalls Island	North America
Llanegryn	EU
Rezen Saddle	AN
Semnan Province	AS
Holmenkollen National Arena	EU
Trakiya Heights	EU
Murphy Glacier	AN
Valdemarsvik	EU
North Hennepin Community College	North America
European route E25	EU
Balleny Islands	AN
Llanquihue Province	SA
Irrawaddy River	AS
Albania	EU
Eagle Boys	unsure
Volyn	EU
Mount Herzl	AS
East Bladen High School	North America
Whittier College	North America
Greater Nevada Field	North America
La Guajira Desert	SA
Aleko Rock	EU
Kaniv Reservoir	EU
Piccard Cove	AN
Old Trinity Church	North America
Cape Jeremy	AF
Tempi Municipality	EU
Kew Gardens Hills	North America
Minhang District	AS
Peshtera Glacier	EU
Ipoh	AS
Dr. Babasaheb Ambedkar Marathwada University	AS
Trieste	EU
Eights Coast	AN
Christian Democrats	EU
Zed Islands	AN
Walton Arts Center	North America
Langwathby	EU
Pernik Peninsula	EU
Elgar Uplands	AN
Arapaho National Wildlife Refuge	North America
Umarex	EU
Royal National Theatre	EU
Framingham Railroad Station	North America
Damavand	AS
Berkner Island	AN
Tower Island	AN
Khasavyurt	AS
Douglas County, Oregon	North America
Koyambedu	AS
Kotturpuram	AS
Rajshahi Division	AS
Deep Freeze Range	AN
Ruhla	EU
Sarawak	AS
Jacobsburg Environmental Education Center	North America
Palmer Archipelago	AN
Cieszyn	EU
Shetland Islands	EU
Colleville-Montgomery	EU
Shire of Wambo	OC
New England	North America
Ilam Province	AS
Ausa	AS
Montiel	EU
Media Development Authority	AS
Wilson Piedmont Glacier	AN
Hornnes	EU
Valencians	EU
County Fermanagh	EU
Emscher	EU
Piedmont	North America
Lahti	EU
Dhaka City	AS
Mount Harding	AN
Vadnagar	AS
Valletta	EU
Elkhorn Ridge	North America
Dent Island Light	North America
Valhalla Swimming Hall	EU
St James' Church, Sydney	OC
Labrador	North America
Greenwood Valley	North America
Padda Island	AS
70 Pine Street	North America
Alouette Lake	North America
Phobos Ridge	AN
James Ross Island group	AN
Kalahari Desert	AF
Curzon Islands	AN
Wohlthat Mountains	AN
Bastille	EU
Kangaroo Ground	OC
Commerce Court	North America
Disney's Hollywood Studios	North America
Covasna County	EU
Anderson Hills	North America
Alsace-Lorraine	EU
Miles College	North America
Chu Lai Base Area	AS
KBC Bank	EU
Pacific Union College	North America
Hoysala Empire	AS
Lanterman Range	AN
Pea Ridge National Military Park	North America
Namba Station	AS
Cairo American College	AF
Entracque	EU
Huachocolpa District	SA
Atromitos Piraeus F.C.	EU
Martel Inlet	AN
Ryder Glacier	AN
Harold Byrd Mountains	AN
Fendley Glacier	AN
Leiria	EU
Thirteen Colonies	North America
Nares Strait	North America
Totten Glacier	AN
Somali Region	AF
National Waterfront Museum	EU
Miyagi	AS
Berwick Glacier	AN
Hamar	EU
Lake Vostok	AN
Blackrock Castle	EU
Trigono	AN
Pitkevitch Glacier	AN
Lopburi	AS
Rawson Plateau	AN
2013 Internazionali BNL d'Italia	EU
Hogeschool Gent	EU
Porcupine Hills	North America
Ingrid Christensen Coast	AN
Mount Bursey	AN
Gjerpen	EU
Danish Sign Language	EU
Cagliari	EU
Ancient Greece	EU
South Pole Traverse	AN
Muchalls Castle	EU
Salisbury, Rhodesia	AF
War in Donbass	EU
Simeulue	AS
Bruce Plateau	AN
Brabant Island	AN
Southpointe	North America
Hewler	AS
Thimphu	AS
Inami, Toyama	AS
Jafara	AF
Ice Runway	AN
Lefortovo District	EU
Mikkelsen Bay	AN
pont Notre-Dame	EU
Dogpatch USA	North America
University of Washington	North America
Piper Verlag	EU
Huntingdon County	North America
KSTP-FM	North America
Southeast Fairbanks Census Area	North America
Port Harcourt	AF
Ablation Valley	AN
Fossil Butte National Monument	North America
Possession Islands	AN
Tiv people	AF
Zechstein	EU
Poplar River First Nation	North America
Montour County	North America
Goseck circle	EU
Markham District High School	North America
Xaverian Brothers High School	North America
Ankenes	EU
Vukov Spomenik	EU
Eibenstock	EU
Tashkent	AS
Punjab, India	AS
Scott Island	AN
Church Hill Tunnel	North America
Annamalai University	AS
Milltown Institute of Theology and Philosophy	EU
Minamiarupusu	AS
Naruto Strait	AS
Canisteo Peninsula	AN
Cape Hordern	AN
1960 Summer Olympics	EU
Minamiakita District	AS
Prince Edward Viaduct	North America
Apollo Peak	AN
Nimbus Hills	AN
Tehran	AS
Central European University	EU
L'Escala	EU
Pidgeon Island	North America
British North America	North America
Palazzo Contarini del Bovolo	EU
Kresttsy	EU
Rufiji River	AF
Brunt Ice Shelf	AN
Taunton River Watershed	North America
Lillie Range	AN
Johnson Glacier	AN
Beaufort Island	AN
Dunnamaggin GAA	EU
Fingask Castle	EU
Don Juan Pond	AN
Klaskanine River	North America
Bluefield College	North America
Transylvanian Plateau	EU
Coronation Island	AN
Whitehall Glacier	AN
Nea Zichni Municipality	EU
Komarichsky District	EU
Boundary Cone	North America
Industrial Design Centre	unsure
Thamshavn Line	EU
Nkawkaw	AF
Mount San Antonio	North America
Darmstadt	EU
Kirkby Glacier	AN
Parippally	AS
Virgin Classics	unsure
AH3	AS
Cape Chocolate	AF
Menen	EU
Solan District	AS
Byzantine & Christian Museum	EU
Raimund Theater	EU
CNH Industrial	EU
Beirut	AS
Pont du Carrousel	EU
Tyabb	OC
N-340 road	EU
Cape Yelcho	SA
Piatt County	North America
Bukovina	EU
Muncie Central High School	North America
Franz Liszt Academy of Music	EU
Thomas Glacier	AN
Sam Hill Memorial Bridge	North America
Boroughmuir High School	EU
Rickenbacker Air National Guard Base	North America
Kuala Langat	AS
Bering Glacier	North America
Yangtze	AS
Thule people	North America
Mongolia	AS
Cape Selborne	AF
Tshwane Metropolitan Municipality	AF
SooToday.com	unsure
Clipper Magazine Stadium	North America
City of Boroondara	OC
La Spezia	EU
East Kildonan, Winnipeg	North America
Swedish Orphan Biovitrum	EU
Mapple Glacier	AN
Griebnitz Canal	EU
Cordiner Peaks	AN
County Leitrim	EU
English Coast	EU
Hickory Run State Park	North America
Bourgeois Fjord	North America
Oxshott	EU
Regla	North America
Colombes	EU
Sun News Network	North America
Bobolice	EU
Benson Glacier	AN
Judith River Group	North America
Bishop Loughlin Memorial High School	North America
Santa Fe Trail	North America
Beardmore Glacier	AN
Lincoln Financial Field	North America
Liffey River	EU
Tinguiririca River	SA
Caradon Hill	EU
Stefaneschi Triptych	EU
Mugello Circuit	EU
assassination of John F. Kennedy	North America
Lakewood Church	North America
Mount Karisimbi	AF
Ljig	EU
Taunsa Barrage	AS
Bellagio	EU
Maitri	AS
Ferrer Point	AN
Ouachita National Forest	North America
Zion Canyon	North America
DuPage County	North America
Ford Ranges	AN
Leech Lake	North America
Saunders Mountain	AN
Bliesgau	EU
Worcester Range	AN
Ostankinsky District	EU
Almaty	AS
Helensvale railway station	OC
Chuprene Glacier	EU
Distrito Federal	North America
Dutch	EU
Bryan Air Force Base	North America
Mexican	North America
East Humboldt Range	North America
Hultsfred Municipality	EU
archdiocese of Gatineau	North America
Linimo	AS
Rhine	EU
McKinley Climatic Laboratory	North America
Scott Base	AN
Patrick Henry College	North America
Sonitpur district	AS
French Algeria	AF
Larsmo	EU
Watt Bay	OC
Costa Rica	North America
Kryvyi Rih	EU
Longs Peak	North America
Cape Ducorps	AN
Shinnan Glacier	AN
Colegio Nacional de Buenos Aires	SA
Gramercy Park	North America
Mount St Gwinear	OC
Dar es Salaam	AF
Tartessos	EU
Bitterroot Mountains	North America
Cape Adare	AN
2004 IAAF World Cross Country Championships	AF
Wilmington	North America
Middle East	AS
Victory Mountains	AN
La Plata	SA
Khorramdarreh Rural District	AS
Hershey Country Club	North America
N'Djamena	AF
Shackleton Ice Shelf	AN
Aragonese	EU
Suvorov Glacier	AN
United Arab Emirates	AS
Pandoh Dam	AS
Diablo Canyon Power Plant	North America
Terningskarvet Mountain	EU
Via Ardeatina	EU
Sentinel Range	AN
Fort Nashborough	North America
Kharga Oasis	AF
McCuddin Mountains	AN
Congo Free State	AF
California Plateau	North America
Northwest Branch Anacostia River	North America
Warszawa	EU
Vierlingsbeek	EU
Read Mountains	AN
Alcanena Municipality	EU
United Kingdom of the Netherlands	EU
Sikkim	AS
Kozani	EU
Bjurholm	EU
Mount Cupola	AN
Nakheel Tower	AS
Hesperides Hill	AN
Northern Territory	OC
Sequence Hills	AN
Nordstrand IF	EU
Fredriksen Island	AN
Legnica County	EU
Moyamensing	North America
Black Pine Mountains	North America
Zenshuji	AS
E.ON Sverige	EU
Danco Coast	AN
Batterbee Mountains	AN
Ismoil Somoni Peak	AS
Ol Doinyo Lengai	AF
Langarud County	AS
East Pakistan	AS
Moscato d'Asti	EU
Silverstein Peak	AN
Law Dome	AN
Gabbro Hills	North America
Chartered Professional Accountant	unsure
Derna District	AF
Vestfold Hills	AN
Brugmann Mountains	AN
Catanzaro	EU
Hammarby IF DFF	EU
Vijayawada Junction railway station	AS
Sevtopolis Peak	EU
Thuringian Highland	EU
Dhule	AS
Lwów	EU
Mount Newall	OC
Kurze Mountains	AN
Camp Myles Standish	North America
Drighlington	EU
Shaanxi	AS
Circuito da Boavista	EU
Venetian	EU
Pontigny Abbey	EU
Cathedral Rocks	AN
Pirrit Hills	AN
Asquith	North America
Patuxent Wildlife Research Center	North America
Lincolnshire	EU
Interstate 255	North America
Sarnia	North America
Kiryat Moshe	AS
Mount Spivey	North America
Mediglia	EU
Al-Hasakah Governorate	AS
HRL Laboratories	North America
DF	North America
Flatvaer Islands	EU
Vaughan Inlet	North America
Lake Texana	North America
Bigourdan Fjord	AN
Zaanstad	EU
Lincoln Square Synagogue	North America
Barnhartvale, Kamloops	North America
Cape Kinsey	North America
Fifth Avenue	North America
Demay Point	AN
Kojur District	AS
Whirlwind Inlet	AN
Jordan	AS
Phillips County	North America
Bad Vilbel	EU
Krogh Island	AN
Brickell Key	North America
Liv Glacier	AN
Josefstadt	EU
Adelaide Island	AN
Tunis	AF
Dutch Republic	EU
San Antonio	North America
Granite Knolls	North America
Luanda	AF
Carrizo Plain	North America
Gornate-Olona	EU
Mannheim City Airport	EU
Tagus river	EU
Bamyan	AS
Fuzhou	AS
Slovenian	EU
Skinnamarink TV	unsure
Vayots Dzor Region	AS
Sopot Ice Piedmont	AN
Krung Thep	AS
Harris Peninsula	AN
Mount Berlin	AN
Indigirka River	AS
Iberia Parish	North America
Everett Range	AN
William Scoresby Archipelago	AN
ERT World	unsure
Largo Island	AN
Shirley Island	AN
Wellington Catholic District School Board	North America
Lanzhou	AS
Pune	AS
Tupungato	SA
Gio Linh	AS
Napier Mountains	AN
Ikaalinen	EU
Hardoi district	AS
Kanchenjunga	AS
Kosamba	AS
Mount Dallmann	AN
Mendelssohn Inlet	AN
Georgians	unsure
Mel Lastman Square	North America
Lajran Rural District	AS
National War Museum	North America
Gelderland	EU
Westerburg	EU
Ezhupunna	AS
Herbert Mountains	AN
Douro	EU
Poweshiek County	North America
William Scoresby Bay	AN
Union des forces progressistes	unsure
Gramercy Park Hotel	North America
Lexington Avenue	North America
Stara Zagora	EU
Isa Air Base	AS
Kazinga Channel	AF
Hotel Bristol	EU
Meyer Hills	AN
Violante Inlet	AN
Rupanyup	OC
Arena Valley	North America
Knobhead	unsure
Mbale District	AF
Minna Bluff	AN
Piedecuesta	SA
Balham Valley	AN
Shahdol district	AS
Upper Canada District School Board	North America
Lycoming College	North America
Taronga Western Plains Zoo	OC
Cape Archer	AN
Keystone Corridor	North America
Delaware	North America
Tierney Peninsula	AN
Gmina Morawica	EU
North Portal	North America
Idylwyld Drive	North America
Barker Range	OC
Alexander Hamilton Bridge	North America
Linnich	EU
M'Sila Province	AF
The Knoll	AN
Santo Spirito in Sassia	EU
Dniester	EU
Sobat River	AF
Yukon Flats National Wildlife Refuge	North America
Hurricane Ridge	North America
Palmer Station	AN
Neumayer Cliffs	AN
Christiania	EU
Northamptonshire	EU
Morobe Province	OC
Kolad	AS
Putyvl	EU
Roberts Massif	AN
Le Fuilet	EU
Al Ahmadi Governorate	AS
Taranto Sport	EU
South Australia	OC
Shunyi Olympic Rowing-Canoeing Park	AS
Marad massacre	AS
Bracondale Hill	North America
North Brabant	EU
North Carolina	North America
Castellamonte	EU
Cook County, Illinois	North America
Film Forum	North America
Warta	EU
Goa	AS
Kilby Island	North America
Chamarajanagar district	AS
Prince Charles Mountains	AN
Zaraysky District	EU
Ballyfermot	EU
Foulis Castle	AF
Kalamazoo County	North America
Mount Ignatiev	AN
Cape Filchner	AN
Moubray Glacier	AN
Loschwitz	EU
Siazan District	AS
Mittag-Leffler Institute	EU
North Macedonia	EU
Periyar University	AS
Brownhills	EU
DESTATIS	EU
Katowice	EU
Villigen	EU
Yovkov Point	AN
Shiraz	AS
Beaumont Glacier	AN
Parkland County	North America
Anderson Heights	AN
Insel Range	AN
Nanyang Technological University	AS
Marshall Space Flight Center	North America
Zemen Knoll	EU
Wallow Fire	North America
Koboko District	AF
River Clyde	EU
Bolpur	AS
Breidnes Peninsula	AN
Senegambia Confederation	AF
Yunnan Province	AS
County Carlow	EU
K.S.V. Roeselare	EU
Many Peaks	OC
Newstead House Board of Trustees	OC
Essex	EU
North Shore Medical Center	North America
Leverett Glacier	AN
Campeche Bank	North America
FR Germany	EU
Wright Inlet	AN
Box Elder County	North America
Gmina Warlubie	EU
Hercules Inlet	AN
Manipur	AS
Mukhed	AS
Reeves Glacier	AN
Inn	EU
Mont Saint-Bruno	North America
M-140	EU
Wiener Singakademie	EU
Kama River	EU
Bicol Region	AS
Archar Peninsula	AN
Samuel Point	AN
Laslea	EU
Yambol Peak	EU
Cancello	EU
Lake Abitibi	North America
Arundel Formation	North America
Coast Mountains	North America
Northwind Glacier	AN
Baron de Hirsch Cemetery, Halifax	North America
Vermilion	North America
Mount McCoy	North America
Lake Baikal	AS
Shibganj Upazila, Bogra District	AS
Svarthamaren Mountain	AN
Cumberland University	North America
Preet Vihar	AS
Kungliga Svenska Segelsällskapet	EU
Tarnobrzeg Voivodeship	EU
Block Bay	AN
Primorsky Krai	AS
Catholic Syrian Bank	AS
East Francia	EU
Noosa Heads	OC
Rydberg Peninsula	AN
Biberach district	EU
Morris Rock	AN
Gmina Konarzyny	EU
Enterprise Island	AN
Breaux Bridge	North America
Wakefield Park	OC
Ferrobaires	SA
Birendranagar	AS
Austkampane Hills	AN
Malta Plateau	AN
Gela	EU
Greve	EU
Coomera River	OC
Lucentum	EU
Moi International Sports Centre	AF
Himachal Pradesh	AS
Padua	EU
Isle of Raasay	EU
Guillaumes	EU
Dorogomilovo District	EU
Somerset Land District	AN
A227 road	EU
Niederweningen	EU
Mpumalanga	AF
Lavoisier Island	AN
Mount Bayonne	AN
Bangui	AF
Giurgiu County	EU
Kennedy Highway	OC
Monessen	North America
Grossman Nunataks	AN
Fold Island	AN
Rottendorf	EU
Cole Peninsula	AN
Ninnis Glacier	AN
Oman	AS
Kingsborough Community College	North America
Wildcat Hills	North America
Le Puy Foot 43 Auvergne	EU
Grolsch Brewery	EU
Sam Rayburn Reservoir	North America
Honkala Island	AN
Siemiatycze	EU
Long Beach Polytechnic High School	North America
Muskegon River	North America
Losiny Ostrov National Park	EU
Veliko Tarnovo	EU
Facit	EU
Brazos Wind Farm	North America
Lochaline	EU
Kermit, Texas	North America
Puebla	North America
Lake Conroe	North America
Kingston Whig-Standard	North America
Fairfield West	OC
Cheyenne Frontier Days	North America
Pindamonhangaba	SA
Husky Massif	AN
Support Force Glacier	AN
Misnomer Point	AN
Perak	AS
Cape Royds	AN
Geffen Award	AS
Mac. Robertson Land	AN
Scheldt	EU
Tell Rifaat	AS
Swann Memorial Fountain	North America
Mount Dido	AN
Lyon Nunataks	AN
Mobiloil Inlet	North America
Northland	OC
Mount McClintock	AN
Niagara County, New York	North America
Melilla	AF
Findhorn Foundation	EU
Attingal	AS
Queen Elizabeth Land	AN
Cheshire	EU
Tang Dynasty	AS
Chambal River	AS
Inuit Circumpolar Council	North America
Niger River	AF
Hanover Tavern	North America
Wazzin	AF
Biscay	EU
Ceredigion County Council	EU
Lancaster Catholic High School	North America
Stockholm County	EU
Quinton Point	North America
Hutton Mountains	AN
Jewish Museum	unsure
Ma'an Governorate	AS
Autauga County	North America
Bruce County	North America
United Mine Workers	North America
Oseberg oil field	EU
2010 Belgian federal election	EU
Habsburg Monarchy	EU
Gdynia	EU
Vestreskorve Glacier	AN
Segura	EU
Cape Monaco	North America
Banaskantha district	AS
El Tarf Province	AF
Alor Setar	AS
Asian Highway Network	AS
Camp Mabry	North America
Kuantan	AS
Altare della Patria	EU
Craddock Massif	AN
Silesian Voivodeship	EU
Auchenharvie Castle	EU
Hilton Inlet	AN
Aviator Glacier	AN
Skelton Glacier	AN
Spirit Mountain Wilderness	North America
Mizoram	AS
Berar Province	AS
Titograd	EU
Forrestal Range	AN
Wesley Hospital	OC
Rutgers Preparatory School	North America
2004 Indian Ocean earthquake	AS
Snowdon	EU
Neighbourhoods in Kolkata	AS
Arjoun	AS
Boguchany Dam	EU
Omusati region	AF
Imperia	EU
Schofield Barracks	North America
Bosporan Kingdom	EU
National Congress of Brasil	SA
Kayunga District	AF
Astrid Lindgren Memorial Award	EU
South East Cape	OC
Cunter	EU
Kakata	AF
Pirkanmaa	EU
Hersbruck	EU
Capolago	EU
Lebanese	AS
Emba River	EU
Kluuvi	EU
Singarapettai	AS
Pannonhalma Archabbey	EU
Kanchanaburi	AS
Dwarka	AS
Everberg	EU
Free National Movement	North America
Oliver Ames High School	North America
Lombard kingdom	EU
Subarnapur district	AS
Firenze	EU
Grand Mosque of Paris	EU
Nauders	EU
Sana'a International Airport	AS
East Karelia	EU
Cmolas	EU
Fukuno, Toyama	AS
Cubagua	SA
Doha	AS
Northern Samar	AS
Siquijor	AS
Adliswil	EU
Ulundurpet	AS
Wanne-Eickel Central Station	EU
Sabburah Subdistrict	AS
Madala	AF
Al-Suqaylabiyah Subdistrict	AS
Band-e Kaisar	AS
Mandara Mountains	AF
Akure	AF
Rathen	EU
Jervis Inlet	North America
Albertis Castle	EU
Bungsberg	EU
Dospat Municipality	EU
Piazza al Serchio	EU
Juba	AF
Sofia City Province	EU
Farrington High School	OC
Stentoften Runestone	EU
Lake Caliraya	AS
Sands of Beirut	AS
Maella	EU
Lindholm station	EU
Ust-Katav	EU
Hellenic Police	EU
Mauna Kea	OC
Mamou Region	AF
Mudgee	OC
Tudeshk Rural District	AS
Ytyk-Kyuyol	AS
Nobel Peace Center	EU
City of Hervey Bay	OC
Romanian	EU
Ust-Maya	AS
West Darfur	AF
Deputatsky	AS
Bighorn Basin	North America
Garabit viaduct	EU
Lakeridge Health Oshawa	North America
Centre Pierre Charbonneau	North America
West Norfolk	EU
Grobbendonk	EU
Davao Region	AS
Lambunao	AS
Orpheus Island National Park	OC
Bay	AF
Argentine National Anthem	SA
Galata	AS
Elk State Park	North America
Sialkot district	AS
Sumulong Highway	AS
Ovada	EU
Ikuno-ku	AS
Phoenix Symphony Hall	North America
Rudrur	AS
Habitat 67	North America
Rottumerplaat	EU
Tsubaki Grand Shrine	AS
Romano d'Ezzelino	EU
Eurasian Steppe	EU
Little Stirrup Cay	North America
Pochepsky District	EU
Kitakami Station	AS
Eerbeek	EU
Shichikashuku	AS
Gmina Bodzentyn	EU
Conakry Region	AF
al-Qahira	AF
Augustdorf	EU
East Wall	EU
Ledaal	EU
Lutvann	EU
Kapar	AS
Soalala District	AF
Now Kandeh District	AS
Mezhdurechensky District	EU
Beckingen	EU
Spanish Armed Forces	EU
Badoc	AS
Entzheim	EU
Boinpalle mandal	AS
Surazh	EU
New Era University	AS
Southern Savonia	EU
Istanbul Airport	AS
Sears Point	North America
Western Bug	EU
Portuguese	EU
Bilecik Province	AS
Tiraspol	EU
Panteion University	EU
Passeier Valley	EU
Pamukkale	AS
Polish	EU
Porto Azzurro	EU
Russian	EU
Golden Gate National Recreation Area	North America
TUIfly Nordic	EU
Pilis Mountains	EU
Puerto Rican	North America
public transport in Istanbul	AS
Edirne Province	AS
Tirebolu	AS
French protectorate	AF
Burdur Province	AS
Osmaniye Province	AS
Ankara	AS
Narman	AS
Surabaya	AS
Antalya Province	AS
Soviet Russia	EU
Berea District	AF
North Korean	AS
Sakarya Province	AS
Zaragoza	EU
Taksim Military Barracks	AS
Kaveri River	AS
Junnar	AS
French Southern and Antarctic Lands	AN
Rothera Station	AN
Khabarovsk	AS
Gambia River	AF
Mont Blanc	EU
Wuhan	AS
Rutford Ice Stream	AN
Lemaire Island	AN
Hudson Mountains	AN
Stonington Island	AN
Shebelle River	AF
Macedonian	EU
Yoruba religion	AF
Mount Queequeg	AN
Langnes Peninsula	AN
Kaliakra Glacier	AN
McDonald Heights	AN
Urdoviza Glacier	AN
Snakeskin Glacier	AN
Trail Inlet	AN
Irish Free State	EU
Yorkshire	EU
Mount Bentley	AN
Onyx River	AN
Mount Cocks	AN
Saint Johns Range	AN
Daugava River	EU
Wylie Bay	AN
Splettstoesser Glacier	AN
Hull Glacier	AN
Schytt Glacier	AN
Millerand Island	AN
Davis Station	AN
Scar Inlet	AN
Carlini Station	AN
Kouilou-Niari River	AF
Supporters Range	AN
Rayner Glacier	AN
Yugoslav	EU
Booth Island	AN
Charlotte Bay	AN
Camp Academia	AN
Garwood Valley	AN
Estonian	EU
Ardery Island	AN
Peking	AS
Lomonosov Mountains	AN
East Ongul Island	AN
Marinid dynasty	AF
Bowman Coast	AN
Wright Lower Glacier	AN
Bach Ice Shelf	AN
Swedish	unsure
